# This puzzle is solvable
10
 97  34  43  70  37  98  46  38  71  75
 72  80  41   1  84  51  39   9  61  31
 27  58   8  64  13   7  66  44  35  65
 85  63  33  89  93  15   0   5  12  86
  3  99  81  57   2   4  14   6  42  16
 82  94  69  23  92  24  52  11  10  56
 45  22  79  88  17  28  47  26  77  91
 32  78  50  54  21  59  36  76  20  18
 95  87  83  74  68  73  25  19  49  67
 90  30  48  60  96  29  40  53  55  62
