# This puzzle is solvable
12
 79  43  44  83  80   1   4 112   5  10  18  21
 32  42  85 137   3  84  53  82 117  13  14  16
108   7  76 110 122 113  56  81  58  87  11  88
111  51   9  74  48  50  52  17  12  89   0  86
 40 135 128 116  61 121  15 120  57  46   8  54
 78  97  36  77 106  45   6  69  20 141 142  49
 47  39 127  91 109 131  28 115  59  23 132  66
126  72  63 130 134  67 100 140  99  62 107  25
 73   2 102  70  41  93  37 129 119 139 136  90
 30  75  33 103 124  64  92 125  68  55  94  60
 98 105 104 133 101  24 123  35  22  29 118  96
143  38  34  31  19 138  27  65  71  95 114  26
