# This puzzle is solvable
15
 55 149 103 105 104 176   7 208 113 108  11  65 182 116  13
 56   4  64 146  60  71   6  59 215  66 178  12 153  15  17
 57  61  62 145 177   2 183 114   9  10 117   8  70  69 156
  1   3 102 138  50 107 210 150 151  72  20 111  14 115  23
173  48 100  49  63 175 148 147 216  67 217  18 186 112 219
 58 101 144 224 142 155 180 163 199 122  75 222 204 203 106
 94 201 135 198 202 143 218 109 154  68 184 119 157 209  16
 42   5 223 140  53 152 192 174 213 159 158 205  74  73  19
170  52 171 133  98 165 197 200  37  81 206 126  21 118 188
172  97 137  47  54  86 179 211 187  34 162 120 185  77 160
 40  51 136 220 134 195 141 110 221 207  24  76  22  82  25
214   0 196 131  95 139 167 194 190  87  78  32  84  79  29
 44 181  45 169 129  43  38 212  85 127 128 164 123 161  83
 88  90  96 193 168 130  41 189 166  31  27 125 121 124  26
 46  99  35  92 132  93  39  91  89 191  36  33  80  30  28
