# This puzzle is solvable
8
 7 32 22  2 29 10 40  9
30 57 37 46  8 36 31 16
38 44 39  5 61 47 52 14
42 27 21 43 25 56 17 24
41 55 59 11 49 58 35 54
15 28  0 34 53  3 19 18
 6 48  4 62  1 20 13 45
63 26 33 51 50 60 12 23
