# This puzzle is unsolvable
8
28 27 39 50 58 34 16 47
12 61  4 63  0  2 26  5
38  6 19 44 31  9 59 55
54 30 42 45 17 53  8 37
51 49 11 33 25 57 23 35
15 29  7 56 62 40 18 13
24 21 60 20 48  3 10  1
32 52 43 46 22 36 14 41
