# This puzzle is unsolvable
15
171  57  10   4   0 217  60   8  63  65 111  11  14  15 157
 58  98  56 143 147 148 109  54  59 220   7  66  71  13 117
107 199   5 103   2 141  64  61  67  68  12  17 149 205 186
  1 102  95 106 142   3  62 181 110 112 116  77 153  72 108
104  52 177 176 219   6 178 115 183 202   9 121 158 150  75
 55 173  53 144  99 105 182 146 180 215 203 184  16 113  73
 48 101  50 145  51 198 193 185 179  96  70  21 204  18 120
218 216 196 206  44 140 201  36 190 192  19  69 156 123  23
 42 200 214 210 136 197 155 211 166 114  84  76  26  78 209
100 195 138 223 151  46 167 208 152 191 119 161 124  24  30
137  89 224 175 222  22 162  35 125 118  33  82  74  20  27
 94 194  93 139 135 128  38 187 131 154 160 163  81 189 122
212  49  45 172 168  87 165  40 221  90 129 207 127 159 188
 41 133  43 134 169  88 174  91  97  37  34  32  28  25  29
170  47  39 213 132  85  86  92 164  79 130  83  80 126  31
